1111111
12   11
1    51
1    11
13   11
1    41
1    11
1111111

111111
11   1
12 3 1
11   1
11   1
115141
111111

111111
121111
1   11
1   41
1   11
115111
111111
